111111111111111111111111111111111111111111
100001010000001001C01000100100001000000101
10010001001000100100000000010010100C100101
101111111111101101001000100101101101111101
10P010010001001001111110111100100001010101
1000000100000010110010000001101110010001C1
100010000111011000001C00100100001000000101
110111110001001001011110101111111111101101
100010011101111001000000100100101001000101
10000001E0010010111110111100001000C1000101
111011010000001001000000000100C01000000101
100010010001001001000100100111011111110001
110111111111111001110100100100001001010101
100010010010100011000110101100001000010101
1000100100101C1001000100100111011110110101
101110000000101011011111111100001000010101
10001001000C101001000101000100001000010101
10111111110110100100010100011101100100C101
100010010000001001000101110100000011111101
100010010000101101110101000100001000000101
100000C00010101001000000000100101001000101
111111111111111111111111111111111111111111
111111111111111111111111111111111111111111
111111111111111111111111111111111111111111
111111111111111111111111111111111111111111
111111111111111111111111111111111111111111
111111111111111111111111111111111111111111
111111111111111111111111111111111111111111
111111111111111111111111111111111111111111
111111111111111111111111111111111111111111
111111111111111111111111111111111111111111
111111111111111111111111111111111111111111
111111111111111111111111111111111111111111
111111111111111111111111111111111111111111
111111111111111111111111111111111111111111
111111111111111111111111111111111111111111
111111111111111111111111111111111111111111